R 1920 1080

C 167,242,255
F 255,171,60

NO textures/mariowall.xpm
SO textures/N_wall.xpm
EA textures/mariowall1.xpm
WE textures/mariowall3.xpm
S textures/bitcoin.xpm

111111111111111111111111
100000000000000000000001
10000000000200000000000111111111111111111111111111
10000000000000000000000000000000000000000000000001
10000000000000000000000000000000200000000000000001
10000000000000000000000111111111111000111111111111
100000000000000000000001          10001
100000000000000000000001          10001
111111111000011111111111          10001
        100001                    10001111111
        102001                    10000000001
        111111                    100N0000001
                                  10000020111
                                  11111111